NO textures/redbrick.xpm
SO textures/bluestone.xpm
WE textures/eagle.xpm
EA textures/greystone.xpm

F 0,100,50
C 225,30,50

1111111111
1111111111
