NO textures/redbrick.xpm
SO textures/bluestone.xpm
WE textures/eagle.xpm
EA textures/greystone.xpm

F 0,100,50
C 225,30,50

		11111111111111111111111111       		11111111111111111111111111       
		111111111001100000000000011111111		111111111001100000000000011111111
		        1011000001110000000000001		        1011000001110000000000001
		11111   1110000000000000001111111		11111   1110000000000000001111111
1111111110111     111000000000000111     1111111110111     111000000000000111     
1000000000111111111111111101111111       1000000000111111111111111101111111       
11110111111111011100000010001            11110111111111011100000010001            
111101111111110111010100100011           111101111111110111010100100011           
11000000110101011100000010001            11000000110101011100000010001            
100000000000000011000000100011           100000000000000011000000100011           
10000000000000001101010010001            10000000000000001101010010001            
1100000111010101111101111000111          1100000111010101111101111000111          
1111E111 1110101 101111010001            11111111 1110101 101111010001            
11111111 1111111 111111111111            11111111 1111111 111111111111            

